11111111
1CPCCE11
11111111

111

11111111111