1111111111111111111
100P00000001000C101
1010010100000000001
10101000101C1111111
100010000001E001001
1100101000000000011
10100000000C1010001
1000100000000001001
1000101000000000011
10C0000000000000001
1111111111111111111
