1111111111111111111
1E100000000000000P1
1010000011111111111
10101C0010000011111
1000100000000011111
1000101000100000011
10001C10001C00100C1
1111111111111111111
