1111111111111111111111
10C000010001000C100001
1110011100000000100001
10000000000C1010000001
100010000001E000000P01
1100000000000000010001
10000000000C1010000001
1111111111111111111111
