111111
1C0001
1P00E1
1C0001
111111
