111111111111
1C1001000001
101001000011
10100C001111
101P100000E1
10C010100011
11CC1C100C11
111111111111
