1111111111111111111
1P10000000000000001
1010111010000000001
10101C001E100010001
1000100011100011111
1000101000100000011
10001C10001C00100C1
1111111111111111111
