111111111111
1C0000011001
101000000011
10111C001111
1000100000E1
10C010100011
10P01C100C11
111111111111
