1111111111111111111
100000000001000C101
1010010100000000001
10101000101C1010001
100010000001E001001
1100101000000000011
10101110101C1010001
1000100000010001001
1100101000000000011
10101110101C1010P01
1111111111111111111
