1111111111111111111111111111111111
100000000001000C1000000C0000000001
101001010000000010100000E000010101
10101110101C1010111111001111110101
1000100000010001000P00000000001001
1111111111111111111111111111111111
