1111111111111111111111111111111111
100000000001000C0000000C0000000001
10100101001E0000101001000000010101
10101110101C1010001001000000010101
10001P0000010000000000000000000001
1111111111111111111111111111111111
