1111111111111111111
100P00C00000000C001
1000011000000000001
1001100000001000001
10000000000C0001111
1111C00000000000C11
1EC00000000000000C1
1111111111111111111
