111111111111
1C0000100001
111100100001
100100100101
1001E00001C1
100111000101
1C000000C1P1
111111111111
