111111111111
1C10000000C1
101000001111
10101C001001
100010000001
10C01P100011
1E001C100C11
111111111111
