1111111111111111111111111111111111
100000000000000C0000000C0000000001
1010010100100000101001000000010101
1010111010101010001001000000010101
10001P000C00000E000000000000000001
1111111111111111111111111111111111
