11111111111
1C100C000C1
1P100100111
100001000E1
1000C1C00C1
11111111111
