111111111111111111111111
1E0000010000101111111111
10100101C010010011111111
1010C100111C10000100C0C1
101010001100000C01001111
10C0001000000C0001000001
11001C100C10000C01111001
10C0001000100C0000000001
11C01C100C10000C00011111
11CC1C100C10000001000001
10C0001000000C01010C10P1
111111111111111111111111