1111111111111111111111111111111111
1E0000000000000C00000C000000000001
1010010100110000101001000000010101
101001001010101000100P000000010100
1P0000000C10C1000000000000000000C1
1111111111111110111111111111111111
