111111111111111111111111
10E000C00000P000C0000001
111111111111111111111111
