111111111111111111111111
1CE000C00000P000C0000001
111111111111111111111111
