111111111
1CE000001
101101001
111001001
1P0000011
111111111

