1111111111111111111111111111111111
1E0010000000000C00000C000000000001
1011010100100000101001000000010101
1010010010101010001001000000010111
1P0000010C01C0000000000000000010C1
1111111111111111111111111111111111
